Algiers	G
Atlanta	B
Baghdad	G
Bangkok	O
Beijing	O
Bogota	Y
Buenosaires	Y
Cairo	G
Chennai	G
Chicago	B
Delhi	G
Essen	B
Hochiminhcity	O
Hong Kong	O
Istanbul	G
Jakarta	O
Johannesburg	Y
Karachi	G	
Khartoum	Y
Kinshasa	Y
Kolkata	G
Lagos	Y
Lima	Y
London	B
Los Angeles	Y
Madrid	B
Manila	O
Mexico City	Y
Miami	Y
Milan	B
Moscow	G
Mumbai	G
New York	B
Osaka	O
Paris	B
Riyadh	G
San Francisco	B
Santiago	Y
Sao Paulo	Y
Seoul	O
Shanghai	O
St Petersburg	B
Sydney	O
Taipei	O
Tehran	G
Tokyo	O
Toronto	B
Washington B


48 Cities:
G = Grey
O = Orange
Y = Yellow
B = Blue


